AED: UAE dirham
AFN: Afghan afghani
ALL: Albanian lek
AMD: Armenian Dram
ANG: Netherlands Antillian guilder
AOA: Angolan kwanza
ARS: Argentine peso convertible
AWG: Aruban florin
AUD: Australian Dollar
AZN: Azerbaijani manat
BAM: Bosnia and Herzegovina convertible mark
BBD: Barbados Dollar
BDT: Bangladeshi taka
BGN: Bulgarian lev
BHD: Bahraini dinar
BIF: Burundi franc
BMD: Bermudian dollar
BND: Brunei dollar
BOB: Bolivian boliviano
BRL: Brazilian real
BSD: Bahamian dollar
BTN: Bhutanese ngultrum
BWP: Botswana pula
BYN: Belarussian Ruble
BZD: Belize dollar
CAD: Canadian Dollar
CDF: Congolese franc
CHF: Swiss franc
CLP: Chilean peso
CNY: Chinese yuan renminbi
COP: Colombian peso
CRC: Costa Rican colon
CUC: Cuban convertible peso
CUP: Cuban peso national
CVE: Cape Verde escudo
CZK: Czech koruna
DJF: Djibouti franc
DKK: Danish krone
DOP: Dominican peso
DZD: Algerian dinar
EGP: Egyptian pound
ERN: Eritrean nakfa
ETB: Ethiopian birr
EUR: Euro
FJD: Fiji dollar
FKP: Falkland Islands pound
GBP: Pound sterling
GEL: Georgian lari
GHS: Ghanaian cedi
GIP: Gibraltar pound
GMD: Gambian dalasi
GNF: Guinean franc
GTQ: Guatemalan quetzal
GYD: Guyana dollar
HKD: Hong Kong dollar
HNL: Honduran lempira
HRK: Croatian kuna
HTG: Haitian gourde
HUF: Hungarian forint
IDR: Indonesian rupiah
ILS: Israeli new shekel
INR: Indian rupee
IQD: Iraqi dinar
IRR: Iranian rial
ISK: Iceland krona
JMD: Jamaican dollar
JOD: Jordanian dinar
JPY: Japanese yen
KES: Kenyan shilling
KGS: Kyrgyzstani som
KHR: Cambodian riel
KMF: Comorian franc
KPW: North Korean won
KRW: South Korean won
KWD: Kuwaiti dinar
KYD: Cayman Islands dollar
KZT: Kazakhstani tenge
LAK: Lao kip
LBP: Lebanese pound
LKR: Sri Lankan rupee
LRD: Liberian dollar
LSL: Lesotho loti
LYD: Libyan dinar
MAD: Moroccan dirham
MDL: Moldovan leu
MGA: Malagasy ariary
MKD: Macedonian denar
MMK: Myanmar kyat
MNT: Mongolian tugrik
MOP: Macanese pataca
MRU: Mauritanian ouguiya
MUR: Mauritius rupee
MVR: Maldivian rufiyaa
MWK: Malawian kwacha
MXN: Mexican Peso
MYR: Malaysian ringgit
MZN: Mozambican metical
NAD: Namibian dollar
NGN: Nigerian naira
NIO: Nicaraguan cordoba oro
NOK: Norwegian krone
NPR: Nepalese rupee
NZD: New Zealand dollar
OMR: Omani rial
PAB: Panamanian balboa
PEN: Peruvian nuevo sol
PGK: Papua New Guinean kina
PHP: Philippine peso
PKR: Pakistani rupee
PLN: Polish zloty
PYG: Paraguayan guarani
QAR: Qatari rial
RON: Romanian leu
RSD: Serbian dinar
RUB: Russian ruble
RWF: Rwandan franc
SAR: Saudi riyal
SBD: Solomon Islands dollar
SCR: Seychellois rupee
SDG: Sudanese pound
SEK: Swedish krona
SGD: Singapore dollar
SHP: Saint Helena pound
SLL: Sierra Leonean leone
SOS: Somali shilling
SRD: Surinamese dollar
SSP: South Sudanese pound
STN: Sao Tome and Principe dobra
SVC: Salvadoran col√≥n
SYP: Syrian pound
SZL: Swazi lilangeni
THB: Thai baht
TJS: Tajikistani somoni
TMT: Turkmenistani manat
TND: Tunisian dinar
TOP: Tongan pa'anga
TRY: Turkish lira
TTD: Trinidad and Tobago dollar
TWD: New Taiwan dollar
TZS: Tanzanian shilling
UAH: Ukrainian hryvnia
UGX: Ugandan shilling
USD: United States dollar
UYU: Uruguayan peso
UZS: Uzbekistan Sum
VES: Venezuelan bolivar soberano
VND: Vietnamese dong
VUV: Vanuatu vatu
WST: Samoan tala
XAF: Central African CFA franc BEAC
XAG: Silver
XAU: Gold
XCD: Eastern Caribbean dollar
XOF: West African CFA franc BCEAO
XPD: Palladium
XPF: CFP franc
XPT: Platinum
XTS: Currency code reserved for testing
XXX: No currency
YER: Yemeni rial
ZAR: South African rand
ZMW: Zambian kwacha
ZWL: Zimbabwe dollar
BTC: Bitcoin
ETH: Ethereum